1111111111111111111
100C0000C0000001111
1001011111000001111
1C010000C0000001111
1001000000000E01111
100P1111101100000C1
1111111111111111111